No Name - لا يوجد اسم
Acacia sp. - السنط
Albizia lebbeck - اللبخ، ذقن الباشا
Prosopis chilensis - الغاف التشيلي
Prosopis juliflora - الغاف البحري
Ficus altissima - شجرة القنصل، التين النبيل
Ficus benghalensis - التين البنغالي
Ficus benjamina - التين المتهدل
Ficus carica - التين
Ficus microcarpa var. nitida - الغار الهندي (نيتدا)
Ficus pseudosycomorus - الجميز، الحماط
Ficus religiosa - الفيكس، لسان العصفور
Ficus rubiginosa - شجرة الصدأ
Ficus salicifolia - الأثاب
Ficus sycomorus - الجميز
Phoenix canariensis - نخيل الكناري
Phoenix dactylifera - نخيل البلح
Washingtonia filifera - النخيل المروحي
Washingtonia robusta - نخيل واشنطونيا
Latania loddigesii - اللاتان الأزرق، النخيل المروحي
Sabal palmetto - نخيل البلميط
Acacia ampliceps - السنط أﻣبليسبس
Acacia cuthbertsonii - السنط الفضي
Acacia ehrenbergiana - السلم
Acacia etbaica - العراد
Acacia farnesiana - عنبر، فتنة
Acacia gerrardii var. iraquensis - السنط العراقي
Acacia gerrardii var. najdensis - السنط النجدي
Acacia karroo - سنط كارو
Acacia ligulata - السنط الخيمي
Acacia nilotica var. nilotica - قرض، السنط العربي
Acacia nilotica var. tomentosa - قرض، السنط العربي
Acacia pycnantha - السنط الذهبي
Acacia salicina - سنط كبا
Acacia saligna - سنط سالجنا
Acacia seyal - السنط السيال
Acacia tortilis ssp. raddiana - السمر
Acacia tortilis ssp. spirocarpa - السمر
Acacia victoriae - السنط الأنيق
Agave sisalana - صبار سيسل
Agave attenuata - صبار ذيل الثعلب
Agave angustifolia ‘Marginata’ - الصبار الكاريبي
Agave americana - الصبار الأمريكي
Azadirachta indica - النيم، الشريش
Bauhinia purpurea - خف الجمل
Bombax ceiba - شجيرة الحرير
Bougainvillea spectabilis - الجهنمية
Bougainvillea glabra - جهنمية جرداء
Brachychiton acerifolius - بودرة العفريت
Brachychiton populneus - بودرة العفريت
Caesalpinia pulcherrima - زهرة الطاووس
Callistemon citrinus - فرشة الزجاج
Callistemon viminalis - فرشة الزجاج
Capparis decidua - التنضب، السوس، السداد
Carica papaya - الباباظ
Cassia fistula - خيار شمبر
Cassia glauca - أكاسيا جلوكا
Cassia javanica - الخيار البلدي
Carissa macrocaroa - الياسمين الهندي
Casuarina equisetifolia - الكازوارينا
Ceratonia siliqua - الخروب
Cercidium floridum - الباركنسونيا
Clerodendrum inerme - الياسمين الزفر
Chamaerops humilis - النخيل المروحي
Chilopsis linearis - صفصاف الصحراء
Chorisia speciosa - شجرة خيط الحرير
Citharexylum quadrangulare - السندروس
Citrus aurantiifolia - اللومي
Citrus aurantium - البرتقال المر
Citrus limon - الليمون
Citrus limon 'Trunj' - الأترج
Citrus reticulata - المندرين
Conocarpus erectus - الدمس
Conocarpus lancifolius - الدمس
Cordia myxa - المخيط، الدبق
Cupressus arizonica - السرو الفضي
Cupressus sempervirens - السرو العمودي
Cycas revoluta - السيكاس المرتد
Dalbergia sissoo - السرسوع
Delonix regia - البونسيانا
Dodonaea viscosa - الشث
Duranta erecta - زهرة قطر الندى
Duranta erecta 'Aurea' - زهرة قطر الندى (الأصفر)
Duranta erecta 'Variegata' - زهرة قطر الندى (الملون)
Eriobotrya japonica - البشملة
Eucalyptus camaldulensis - الكينة، الكافور
Eucalyptus globulus - الكينة، الكافور
Eucalyptus gomphocephala - الكينة، الكافور
Euphorbia tirucalli - نبات القلم، أم اللبن
Faidherbia albida - الحراز
Grevillea robusta - البلوط الحريري
Hibiscus tiliaceus - الخبازي الساحلي
Jacaranda mimosifolia - الجكرندا
Jatropha integerrima - الجتروفا
Lagerstroemia indica - الآس المجعد
Lagunaria patersonii - زهرة الربيع، صابون الراعي، بخور مريم
Lantana camara - اللانتانا
Lantana loddierii - حشف
Leucaena leucocephala - اللوسينيا
Leucophyllum frutescens - المرامية الفضية
Lycium shawii - العوسج، العوشز
Maerua crassifolia - السرح، مرو
Mangifera indica - المانجو
Melia azedarach - الزنزلخت
Millettia pinnata - أبو جازية
Moringa oleifera - البان، اليسر
Morus nigra - التوت
Nerium oleander - الدفلة
Olea europaea - الزيتون
Parkinsonia aculeata - الباركنسونيا
Peltophorum pterocarpum - اللهب الأصفر
Pinus halepensis - الصنوبر الحلبي
Pithecellobium dulce - اللوز الهندي
Plumeria obtusa - البلوماريا
Plumeria rubra f. acutifolia - البلوماريا
Prosopis alba - الغاف الأبيض
Psidium guajava - الجوافة
Punica granatum - الرمان
Roystonea regia - النخيل الملكي
Salvadora persica - المسواك، الأراك
Schinus molle - الفلفل رفيع الأوراق
Schinus terebinthifolius - الفلفل عريض الأوراق
Searsia pendulina - وتكاري
Senna alata - السنا المجنح
Sesbania sesban - سيسبان
Strelitzia nicolai - عصفور الجنة
Tabebuia rosea - شجرة البوق
Tamarindus indica - تمر هندي
Tamarix aphylla - الأثل
Tamarix gallica - الأثل الفرنسي
Tamarix nilotica - الأثل، الطرفا
Tecoma stans - تيكومة واقفة
Terminalia arjuna - الترمنيلا
Terminalia catappa - اللوز البجلي
Thespesia populnea - البورتيا
Thevetia peruviana - الدفلة الصفراء
Tipuana tipu - أبو المكارم
Vitex agnus-castus - القنب
Vitex trifolia - القنب
Yucca aloifolia - اليوكا
Ziziphus jujuba - السدر
Ziziphus spina-christi - السدر